XXXXXXXXXXXXXXXXXXXXXXXXX...................................
XXXXXXXXXXXXXXXXXXXXXXXXXX..................................
XXXXXXXXXXXXXXXXXXXXXXXX...##########........##########.....
XXXXXXXXXXXXXX.XXXXXXXXXX...................................
XXXXXXXXXX.XXXXXXXXXXXXXX...................................
XXXXXXXX..XXXX..XXXXXXX.X...................................
XXXX..X.........XXXXXXXX....##########......................
X...X...........X.XXXXXX.....................#..............
XXX.XX......#...X.XXXX..............##########..............
XXXXXXX.....#................................#..............
XXXXX.X.....#................................#..............
XXXXXXX.....#...X..X.X.......................#...X.X..X.....
XXXXXXX.....#...X.XXXXX......................#...X.XXXX.....
XXXXXX......#..XXXXXXXXX.X...................#..XXXXXX.X....
XXXXXXX...XX#XXXXXXXXXXXX....................#.XXXXXXX.X....
XXXXXX..X.XX#XXXXXXXXXXXX....................#..XXXXXXXX..X.
XXXXXXXX.XXX#XXXXXXXXXX.......X.X.XXX........#..XXXXXXXXXXX.
XXXXXXXXXXXX#XXXXX.XXXX........XXX.XX............X.XXXX...XX
XXXXXXXXXXXXXXXXXXXXXXX.......XXXXXXX.................X.XXXX
X.XXXXXXX.XXXXXXXX............XXXXXXX................X..X.XX
XXXXXXXX.X.XXXXXXXX...........XX....X.....................XX
XXXXXXXX..XX.X.XXX............XXXX.X.....................XXX
XXXXXXXX.XXXXXXXXXX...........X...X.X.....................X.
XXXXXXXX.X.X..X.XX.X............X.X.X.....................X.
...............XXX.......XXX.............................XXX

